111111111111111
100C000E0000001
100000000000P01
111111111111111