1111111111111
1000C00000001
100CPC0000001
1000C000E0001
1111111111111