1111111111111
1000C0T0A10C1
100CPC0001001
1000C000E1D01
1111111111111